xxxxxxxxxxxxxxxxxxx
xc           x    x
x                xx
xx           x xxxx
xxxxxxxxxxxxtx    x
x            x    x
x      xxxx  x    x
x      x     x    t
x                 t
x          xxxxxxxx
xx        xxxxxxxxx
x                 x
x                 x
t                 x
xxxxxxxxxxxxxe    x
x                 x
x                 x
x    x            x
xxx  x            x
xs   x            x
xxxxxxxxxxxxxxxxxxx