xxxxxxxxxxxxxxxxxxx
xc           x    x
x           e    xx
xx           x xxxx
xxxxxxxxxxxxtx    x
x            x    x
x      xxxx  x    x
x      x     x    t
x                 t
x          xxxxxxxx
xx                x
x                 x
x                 x
t                 x
xxxxxxxxxxxxxxxx  x
x                 x
x                 x
x    x            x
xxx  x            x
xs   x            x
xxxxxxxxxxxxxxxxxxx