xxxxxxxxxxxxxxxxxxx
xc                x
x                 x
x                 x
x                 x
x                 x
x                 x
x                 x
x                 x
x                 x
x                 x
x                 x
x                 x
x                 x
x                 x
x                 x
x                 x
x                 x
x                 x
xs                x
xxxxxxxxxxxxxxxxxxx