xxxxxxxxxxxxxxxxxxx
xc                x
x                xx
xx                x
x                 x
x                 x
x                 x
x                 x
x                 x
x                 x
x                 x
x                 x
x                 x
x                 x
x                 x
x                 x
x                 x
x                 x
x                 x
xs                x
xxxxxxxxxxxxxxxxxxx
